1101111111111111111111111111
10000C0000C100010C1C00100C01
10000E0000010C01001000100001
1111000001110000000000100001
1C0000010000000E000000111001
1P00001100000C00000000000001
11000010C000000000000Q000001
100000000C0000E1000000100001
1111111111111111111111111111
